4 4 4 4 4 4 4 4 4 3 4 1 2 3 1 3 2 1 3 4 
1 1 1 1 1 1 1 1 4 0 0 1 2 3 1 2 4 4 3 4
1 4 1 4 1 4 1 4 4 1 2 3 3 4 4 4 4 3 3 2
4 4 4 1 1 1 4 4 4 4 4 4 4 4 4 3 2 3 4 4
2 3 4 1 4 4 4 4 4 3 3 3 3 3 4 0 0 4 4 3
1 2 4 4 4 4 4 4 4 2 3 1 3 4 4 4 4 3 0 0
AInoob
tele 17 5 map2 0 0
MonsterA 3 0 5
MonsterA 10 3 20
MonsterA 13 3 1