4 4 4 4 4 4 4 4 4
3 3 4 3 2 2 1 3 4
4 3 2 1 3 4 4 4 4
2 3 4 4 4 2 4 4 4
4 4 4 4 4 4 4 4 3
AInoob
tele 8 4 map1 0 0