33 33 33 33 33 33 33 33 33 33 33 33 33 33 33 33
33 33 33 33 33 33 33 38 33 33 33 33 33 33 33 33
4 4 4 4 4 4 4 4 4 4 4 4 4 4 32 33
4 4 4 35 35 35 35 4 4 4 4 4 4 4 4 32
4 4 4 4 4 4 4 4 35 35 35 4 4 4 4 4
4 4 4 35 35 35 35 4 4 4 4 4 4 4 4 4
4 4 4 4 4 4 4 4 35 35 35 4 4 4 4 4
4 4 4 35 35 35 35 4 4 4 4 4 4 4 4 29
4 4 4 4 4 4 4 4 4 4 4 4 4 4 28 33
30 30 30 30 30 30 30 30 30 30 30 30 4 4 33 33
30 30 30 30 30 30 30 30 30 30 30 30 4 4 33 33
AInoob
MonsterA 0 3 6 5
MonsterA 1 10 3 20
MonsterA 0 13 3 1
