33 33 33 33 33 33 33 33 33 33 33 33 33 33 33 33
33 33 33 33 33 33 33 33 33 33 33 33 33 33 33 33
33 34 4 4 4 4 4 4 4 32 34 4 4 4 32 33
34 4 4 36 4 36 4 4 4 4 4 4 36 4 4 32
4 4 4 4 4 4 4 4 4 4 4 4 4 4 4 4
4 4 4 36 4 36 4 4 4 4 4 4 36 4 4 4
4 4 4 4 4 4 4 4 4 4 4 4 4 4 4 4
31 4 4 36 4 36 4 4 4 4 4 4 36 4 4 29
33 31 4 4 4 4 4 4 4 4 29 31 4 4 29 33
33 33 30 30 30 30 30 4 4 33 33 30 30 30	33 33
33 33 33 33 33 33 33 4 4 33 33 33 33 33 33 33