18 18 18 18 18 18 18 18 18 18 18 18 18 18 18 18
18 18 18 18 18 18 18 18 18 18 18 18 18 18 18 18
18 34 4 4 4 4 4 4 4 17 34 4 4 4 17 18
34 4 4 35 4 35 4 4 4 4 4 4 35 4 4 17
4 4 4 4 4 4 4 4 4 4 4 4 4 4 4 4
4 4 4 35 4 35 4 4 4 4 4 4 35 4 4 4
4 4 4 4 4 4 4 4 4 4 4 4 4 4 4 4
31 4 4 35 4 35 4 4 4 4 4 4 35 4 4 29
18 31 4 4 4 4 4 4 4 4 29 31 4 4 29 18
18 18 15 15 15 15 15 4 4 18 18 15 15 15	18 18
18 18 18 18 18 18 18 4 4 18 18 18 18 18 18 18
AInoob
MonsterA 0 5 2 5
MonsterA 1 5 4 20
MonsterA 1 5 6 1
