18 18 18 18 18 18 18 4 4 18 18 18 18 18 18 18
18 18 18 18 38 18 34 4 4 18 18 18 18 18 18 18
18 18 18 34 4 4 4 4 4 18 18 18 18 18 18 18
18 18 34 4 4 4 4 4 4 18 18 18 18 18 18 18
18 34 4 4 4 4 4 4 4 17 18 18 18 18 18 18
4 4 4 4 4 4 4 4 4 4 4 4 4 4 4 4
15 31 4 4 4 4 4 4 4 4 4 4 4 4 15 15
18 18 4 4 4 4 4 4 4 4 4 4 4 4 18 18
18 18 4 4 4 4 4 4 4 4 4 4 4 4 18 18
18 18 15 15 15 15 15 15 15 15 15 15 15 15 18 18 
18 18 18 18 18 18 18 18 18 18 18 18 18 18 18 18
AInoob
MonsterA 0 3 6 5
MonsterA 1 10 3 20
MonsterA 0 5 7 1
MonsterA 1 6 3 20
MonsterA 0 5 3 1
