33 33 33 33 33 33 33 4 4 33 33 33 33 33 33 33
33 33 33 33 38 33 34 4 4 33 33 33 33 33 33 33
33 33 33 34 4 4 4 4 4 33 33 33 33 33 33 33
33 33 34 4 4 4 4 4 4 33 33 33 33 33 33 33
33 34 4 4 4 4 4 4 4 32 33 33 33 33 33 33
4 4 4 4 4 4 4 4 4 4 4 4 4 4 4 4
30 31 4 4 4 4 4 4 4 4 4 4 4 4 30 30
33 33 4 4 4 4 4 4 4 4 4 4 4 4 33 33
33 33 4 4 4 4 4 4 4 4 4 4 4 4 33 33
33 33 30 30 30 30 30 30 30 30 30 30 30 30 33 33 
33 33 33 33 33 33 33 33 33 33 33 33 33 33 33 33
AInoob
MonsterA 0 3 6 5
MonsterA 0 10 3 20
MonsterA 0 13 3 1
MonsterA 1 5 3 20
MonsterA 0 5 3 1
